Winamax Poker - Tournament "Expresso Nitro" buyIn: 1.86€ + 0.14€ level: 1 - HandId: #2695162707761430529-1-1674997339 - Holdem no limit (10/20) - 2023/01/29 13:02:19 UTC
Table: 'Expresso Nitro(627516468)#0' 3-max (real money) Seat #1 is the button
Seat 1: SiLkiii (300)
Seat 2: _SKR (300)
Seat 3: Kariello (300)
*** ANTE/BLINDS ***
_SKR posts small blind 10
Kariello posts big blind 20
Dealt to _SKR [9c 7c]
*** PRE-FLOP *** 
SiLkiii folds
_SKR calls 10
Kariello raises 40 to 60
_SKR folds
Kariello collected 80 from pot
*** SUMMARY ***
Total pot 80 | No rake
Seat 3: Kariello (big blind) won 80


Winamax Poker - Tournament "Expresso Nitro" buyIn: 1.86€ + 0.14€ level: 1 - HandId: #2695162707761430529-2-1674997351 - Holdem no limit (10/20) - 2023/01/29 13:02:31 UTC
Table: 'Expresso Nitro(627516468)#0' 3-max (real money) Seat #2 is the button
Seat 1: SiLkiii (300)
Seat 2: _SKR (280)
Seat 3: Kariello (320)
*** ANTE/BLINDS ***
Kariello posts small blind 10
SiLkiii posts big blind 20
Dealt to _SKR [7d 7c]
*** PRE-FLOP *** 
_SKR raises 260 to 280 and is all-in
Kariello folds
SiLkiii folds
_SKR collected 310 from pot
*** SUMMARY ***
Total pot 310 | No rake
Seat 2: _SKR (button) won 310


Winamax Poker - Tournament "Expresso Nitro" buyIn: 1.86€ + 0.14€ level: 1 - HandId: #2695162707761430529-3-1674997364 - Holdem no limit (10/20) - 2023/01/29 13:02:44 UTC
Table: 'Expresso Nitro(627516468)#0' 3-max (real money) Seat #3 is the button
Seat 1: SiLkiii (280)
Seat 2: _SKR (310)
Seat 3: Kariello (310)
*** ANTE/BLINDS ***
SiLkiii posts small blind 10
_SKR posts big blind 20
Dealt to _SKR [5c Td]
*** PRE-FLOP *** 
Kariello folds
SiLkiii folds
_SKR collected 30 from pot
*** SUMMARY ***
Total pot 30 | No rake
Seat 2: _SKR (big blind) won 30


Winamax Poker - Tournament "Expresso Nitro" buyIn: 1.86€ + 0.14€ level: 1 - HandId: #2695162707761430529-4-1674997374 - Holdem no limit (10/20) - 2023/01/29 13:02:54 UTC
Table: 'Expresso Nitro(627516468)#0' 3-max (real money) Seat #1 is the button
Seat 1: SiLkiii (270)
Seat 2: _SKR (320)
Seat 3: Kariello (310)
*** ANTE/BLINDS ***
_SKR posts small blind 10
Kariello posts big blind 20
Dealt to _SKR [Js 8d]
*** PRE-FLOP *** 
SiLkiii raises 20 to 40
_SKR folds
Kariello folds
SiLkiii collected 70 from pot
*** SUMMARY ***
Total pot 70 | No rake
Seat 1: SiLkiii (button) won 70


Winamax Poker - Tournament "Expresso Nitro" buyIn: 1.86€ + 0.14€ level: 1 - HandId: #2695162707761430529-5-1674997388 - Holdem no limit (10/20) - 2023/01/29 13:03:08 UTC
Table: 'Expresso Nitro(627516468)#0' 3-max (real money) Seat #2 is the button
Seat 1: SiLkiii (300)
Seat 2: _SKR (310)
Seat 3: Kariello (290)
*** ANTE/BLINDS ***
Kariello posts small blind 10
SiLkiii posts big blind 20
Dealt to _SKR [Qc 3h]
*** PRE-FLOP *** 
_SKR folds
Kariello calls 10
SiLkiii checks
*** FLOP *** [4d 4s 5h]
Kariello bets 20
SiLkiii raises 20 to 40
Kariello folds
SiLkiii collected 100 from pot
*** SUMMARY ***
Total pot 100 | No rake
Board: [4d 4s 5h]
Seat 1: SiLkiii (big blind) won 100


Winamax Poker - Tournament "Expresso Nitro" buyIn: 1.86€ + 0.14€ level: 2 - HandId: #2695162707761430529-6-1674997423 - Holdem no limit (15/30) - 2023/01/29 13:03:43 UTC
Table: 'Expresso Nitro(627516468)#0' 3-max (real money) Seat #3 is the button
Seat 1: SiLkiii (340)
Seat 2: _SKR (310)
Seat 3: Kariello (250)
*** ANTE/BLINDS ***
SiLkiii posts small blind 15
_SKR posts big blind 30
Dealt to _SKR [Ts 6s]
*** PRE-FLOP *** 
Kariello folds
SiLkiii folds
_SKR collected 45 from pot
*** SUMMARY ***
Total pot 45 | No rake
Seat 2: _SKR (big blind) won 45


Winamax Poker - Tournament "Expresso Nitro" buyIn: 1.86€ + 0.14€ level: 2 - HandId: #2695162707761430529-7-1674997439 - Holdem no limit (15/30) - 2023/01/29 13:03:59 UTC
Table: 'Expresso Nitro(627516468)#0' 3-max (real money) Seat #1 is the button
Seat 1: SiLkiii (325)
Seat 2: _SKR (325)
Seat 3: Kariello (250)
*** ANTE/BLINDS ***
_SKR posts small blind 15
Kariello posts big blind 30
Dealt to _SKR [5h 2s]
*** PRE-FLOP *** 
SiLkiii raises 30 to 60
_SKR folds
Kariello folds
SiLkiii collected 105 from pot
*** SUMMARY ***
Total pot 105 | No rake
Seat 1: SiLkiii (button) won 105


Winamax Poker - Tournament "Expresso Nitro" buyIn: 1.86€ + 0.14€ level: 3 - HandId: #2695162707761430529-8-1674997460 - Holdem no limit (20/40) - 2023/01/29 13:04:20 UTC
Table: 'Expresso Nitro(627516468)#0' 3-max (real money) Seat #2 is the button
Seat 1: SiLkiii (370)
Seat 2: _SKR (310)
Seat 3: Kariello (220)
*** ANTE/BLINDS ***
Kariello posts small blind 20
SiLkiii posts big blind 40
Dealt to _SKR [4s 3d]
*** PRE-FLOP *** 
_SKR folds
Kariello folds
SiLkiii collected 60 from pot
*** SUMMARY ***
Total pot 60 | No rake
Seat 1: SiLkiii (big blind) won 60


Winamax Poker - Tournament "Expresso Nitro" buyIn: 1.86€ + 0.14€ level: 3 - HandId: #2695162707761430529-9-1674997467 - Holdem no limit (20/40) - 2023/01/29 13:04:27 UTC
Table: 'Expresso Nitro(627516468)#0' 3-max (real money) Seat #3 is the button
Seat 1: SiLkiii (390)
Seat 2: _SKR (310)
Seat 3: Kariello (200)
*** ANTE/BLINDS ***
SiLkiii posts small blind 20
_SKR posts big blind 40
Dealt to _SKR [Ts 2h]
*** PRE-FLOP *** 
Kariello folds
SiLkiii folds
_SKR collected 60 from pot
*** SUMMARY ***
Total pot 60 | No rake
Seat 2: _SKR (big blind) won 60


Winamax Poker - Tournament "Expresso Nitro" buyIn: 1.86€ + 0.14€ level: 3 - HandId: #2695162707761430529-10-1674997475 - Holdem no limit (20/40) - 2023/01/29 13:04:35 UTC
Table: 'Expresso Nitro(627516468)#0' 3-max (real money) Seat #1 is the button
Seat 1: SiLkiii (370)
Seat 2: _SKR (330)
Seat 3: Kariello (200)
*** ANTE/BLINDS ***
_SKR posts small blind 20
Kariello posts big blind 40
Dealt to _SKR [As Ac]
*** PRE-FLOP *** 
SiLkiii folds
_SKR calls 20
Kariello checks
*** FLOP *** [Th 3c 6h]
_SKR bets 40
Kariello calls 40
*** TURN *** [Th 3c 6h][Jd]
_SKR bets 80
Kariello folds
_SKR collected 240 from pot
*** SUMMARY ***
Total pot 240 | No rake
Board: [Th 3c 6h Jd]
Seat 2: _SKR (small blind) won 240


Winamax Poker - Tournament "Expresso Nitro" buyIn: 1.86€ + 0.14€ level: 4 - HandId: #2695162707761430529-11-1674997533 - Holdem no limit (30/60) - 2023/01/29 13:05:33 UTC
Table: 'Expresso Nitro(627516468)#0' 3-max (real money) Seat #2 is the button
Seat 1: SiLkiii (370)
Seat 2: _SKR (410)
Seat 3: Kariello (120)
*** ANTE/BLINDS ***
Kariello posts small blind 30
SiLkiii posts big blind 60
Dealt to _SKR [Qh 2c]
*** PRE-FLOP *** 
_SKR folds
Kariello raises 60 to 120 and is all-in
SiLkiii calls 60
*** FLOP *** [Qs Jc 3d]
*** TURN *** [Qs Jc 3d][As]
*** RIVER *** [Qs Jc 3d As][8s]
*** SHOW DOWN ***
Kariello shows [4c Kd] (High card : Ace)
SiLkiii shows [Ks 5s] (Flush Ace high)
SiLkiii collected 240 from pot
*** SUMMARY ***
Total pot 240 | No rake
Board: [Qs Jc 3d As 8s]
Seat 1: SiLkiii (big blind) showed [Ks 5s] and won 240 with Flush Ace high
Seat 3: Kariello (small blind) showed [4c Kd] and lost with High card : Ace


Winamax Poker - Tournament "Expresso Nitro" buyIn: 1.86€ + 0.14€ level: 4 - HandId: #2695162707761430529-12-1674997556 - Holdem no limit (30/60) - 2023/01/29 13:05:56 UTC
Table: 'Expresso Nitro(627516468)#0' 3-max (real money) Seat #1 is the button
Seat 1: SiLkiii (490)
Seat 2: _SKR (410)
*** ANTE/BLINDS ***
SiLkiii posts small blind 30
_SKR posts big blind 60
Dealt to _SKR [Kd 9s]
*** PRE-FLOP *** 
SiLkiii folds
_SKR collected 90 from pot
*** SUMMARY ***
Total pot 90 | No rake
Seat 2: _SKR (big blind) won 90


Winamax Poker - Tournament "Expresso Nitro" buyIn: 1.86€ + 0.14€ level: 4 - HandId: #2695162707761430529-13-1674997559 - Holdem no limit (30/60) - 2023/01/29 13:05:59 UTC
Table: 'Expresso Nitro(627516468)#0' 3-max (real money) Seat #2 is the button
Seat 1: SiLkiii (460)
Seat 2: _SKR (440)
*** ANTE/BLINDS ***
_SKR posts small blind 30
SiLkiii posts big blind 60
Dealt to _SKR [2c Th]
*** PRE-FLOP *** 
_SKR folds
SiLkiii collected 90 from pot
*** SUMMARY ***
Total pot 90 | No rake
Seat 1: SiLkiii (big blind) won 90


Winamax Poker - Tournament "Expresso Nitro" buyIn: 1.86€ + 0.14€ level: 4 - HandId: #2695162707761430529-14-1674997564 - Holdem no limit (30/60) - 2023/01/29 13:06:04 UTC
Table: 'Expresso Nitro(627516468)#0' 3-max (real money) Seat #1 is the button
Seat 1: SiLkiii (490)
Seat 2: _SKR (410)
*** ANTE/BLINDS ***
SiLkiii posts small blind 30
_SKR posts big blind 60
Dealt to _SKR [Ac Tc]
*** PRE-FLOP *** 
SiLkiii raises 60 to 120
_SKR raises 290 to 410 and is all-in
SiLkiii folds
_SKR collected 530 from pot
*** SUMMARY ***
Total pot 530 | No rake
Seat 2: _SKR (big blind) won 530


Winamax Poker - Tournament "Expresso Nitro" buyIn: 1.86€ + 0.14€ level: 5 - HandId: #2695162707761430529-15-1674997580 - Holdem no limit (40/80) - 2023/01/29 13:06:20 UTC
Table: 'Expresso Nitro(627516468)#0' 3-max (real money) Seat #2 is the button
Seat 1: SiLkiii (370)
Seat 2: _SKR (530)
*** ANTE/BLINDS ***
_SKR posts small blind 40
SiLkiii posts big blind 80
Dealt to _SKR [Td 5s]
*** PRE-FLOP *** 
_SKR folds
SiLkiii collected 120 from pot
*** SUMMARY ***
Total pot 120 | No rake
Seat 1: SiLkiii (big blind) won 120


Winamax Poker - Tournament "Expresso Nitro" buyIn: 1.86€ + 0.14€ level: 5 - HandId: #2695162707761430529-16-1674997587 - Holdem no limit (40/80) - 2023/01/29 13:06:27 UTC
Table: 'Expresso Nitro(627516468)#0' 3-max (real money) Seat #1 is the button
Seat 1: SiLkiii (410)
Seat 2: _SKR (490)
*** ANTE/BLINDS ***
SiLkiii posts small blind 40
_SKR posts big blind 80
Dealt to _SKR [6h Qd]
*** PRE-FLOP *** 
SiLkiii folds
_SKR collected 120 from pot
*** SUMMARY ***
Total pot 120 | No rake
Seat 2: _SKR (big blind) won 120


Winamax Poker - Tournament "Expresso Nitro" buyIn: 1.86€ + 0.14€ level: 5 - HandId: #2695162707761430529-17-1674997599 - Holdem no limit (40/80) - 2023/01/29 13:06:39 UTC
Table: 'Expresso Nitro(627516468)#0' 3-max (real money) Seat #2 is the button
Seat 1: SiLkiii (370)
Seat 2: _SKR (530)
*** ANTE/BLINDS ***
_SKR posts small blind 40
SiLkiii posts big blind 80
Dealt to _SKR [7d 2s]
*** PRE-FLOP *** 
_SKR folds
SiLkiii collected 120 from pot
*** SUMMARY ***
Total pot 120 | No rake
Seat 1: SiLkiii (big blind) won 120


Winamax Poker - Tournament "Expresso Nitro" buyIn: 1.86€ + 0.14€ level: 5 - HandId: #2695162707761430529-18-1674997604 - Holdem no limit (40/80) - 2023/01/29 13:06:44 UTC
Table: 'Expresso Nitro(627516468)#0' 3-max (real money) Seat #1 is the button
Seat 1: SiLkiii (410)
Seat 2: _SKR (490)
*** ANTE/BLINDS ***
SiLkiii posts small blind 40
_SKR posts big blind 80
Dealt to _SKR [6c 5c]
*** PRE-FLOP *** 
SiLkiii raises 80 to 160
_SKR calls 80
*** FLOP *** [Jc Js 6s]
_SKR bets 330 and is all-in
SiLkiii calls 250 and is all-in
*** TURN *** [Jc Js 6s][As]
*** RIVER *** [Jc Js 6s As][2s]
*** SHOW DOWN ***
SiLkiii shows [Qd 7s] (Flush Ace high)
_SKR shows [6c 5c] (Two pairs : Jacks and 6)
_SKR collected 80 from side pot 1
SiLkiii collected 820 from main pot
*** SUMMARY ***
Total pot 900 | No rake
Board: [Jc Js 6s As 2s]
Seat 1: SiLkiii (small blind) (button) showed [Qd 7s] and won 820 with Flush Ace high
Seat 2: _SKR (big blind) showed [6c 5c] and won 80 with Two pairs : Jacks and 6


Winamax Poker - Tournament "Expresso Nitro" buyIn: 1.86€ + 0.14€ level: 6 - HandId: #2695162707761430529-19-1674997641 - Holdem no limit (50/100) - 2023/01/29 13:07:21 UTC
Table: 'Expresso Nitro(627516468)#0' 3-max (real money) Seat #2 is the button
Seat 1: SiLkiii (820)
Seat 2: _SKR (80)
*** ANTE/BLINDS ***
_SKR posts small blind 50
SiLkiii posts big blind 100
Dealt to _SKR [3c Ac]
*** PRE-FLOP *** 
_SKR calls 30 and is all-in
*** FLOP *** [Qh Ah 7s]
*** TURN *** [Qh Ah 7s][Ad]
*** RIVER *** [Qh Ah 7s Ad][9d]
*** SHOW DOWN ***
SiLkiii shows [5c 7h] (Two pairs : Aces and 7)
_SKR shows [3c Ac] (Trips of Aces)
_SKR collected 160 from main pot
SiLkiii collected 20 from side pot 1
*** SUMMARY ***
Total pot 180 | No rake
Board: [Qh Ah 7s Ad 9d]
Seat 1: SiLkiii (big blind) showed [5c 7h] and won 20 with Two pairs : Aces and 7
Seat 2: _SKR (small blind) (button) showed [3c Ac] and won 160 with Trips of Aces


Winamax Poker - Tournament "Expresso Nitro" buyIn: 1.86€ + 0.14€ level: 6 - HandId: #2695162707761430529-20-1674997651 - Holdem no limit (50/100) - 2023/01/29 13:07:31 UTC
Table: 'Expresso Nitro(627516468)#0' 3-max (real money) Seat #1 is the button
Seat 1: SiLkiii (740)
Seat 2: _SKR (160)
*** ANTE/BLINDS ***
SiLkiii posts small blind 50
_SKR posts big blind 100
Dealt to _SKR [Js 4c]
*** PRE-FLOP *** 
SiLkiii raises 100 to 200
_SKR calls 60 and is all-in
*** FLOP *** [Ac Th Qh]
*** TURN *** [Ac Th Qh][7s]
*** RIVER *** [Ac Th Qh 7s][2d]
*** SHOW DOWN ***
SiLkiii shows [6s Jc] (High card : Ace)
_SKR shows [Js 4c] (High card : Ace)
_SKR collected 160 from main pot
SiLkiii collected 200 from side pot 1
*** SUMMARY ***
Total pot 360 | No rake
Board: [Ac Th Qh 7s 2d]
Seat 1: SiLkiii (small blind) (button) showed [6s Jc] and won 200 with High card : Ace
Seat 2: _SKR (big blind) showed [Js 4c] and won 160 with High card : Ace


Winamax Poker - Tournament "Expresso Nitro" buyIn: 1.86€ + 0.14€ level: 6 - HandId: #2695162707761430529-21-1674997664 - Holdem no limit (50/100) - 2023/01/29 13:07:44 UTC
Table: 'Expresso Nitro(627516468)#0' 3-max (real money) Seat #2 is the button
Seat 1: SiLkiii (740)
Seat 2: _SKR (160)
*** ANTE/BLINDS ***
_SKR posts small blind 50
SiLkiii posts big blind 100
Dealt to _SKR [4h 8s]
*** PRE-FLOP *** 
_SKR raises 60 to 160 and is all-in
SiLkiii calls 60
*** FLOP *** [Qs Qh 7d]
*** TURN *** [Qs Qh 7d][Ac]
*** RIVER *** [Qs Qh 7d Ac][Kd]
*** SHOW DOWN ***
_SKR shows [4h 8s] (One pair : Queens)
SiLkiii shows [6s Kc] (Two pairs : Kings and Queens)
SiLkiii collected 320 from pot
*** SUMMARY ***
Total pot 320 | No rake
Board: [Qs Qh 7d Ac Kd]
Seat 1: SiLkiii (big blind) showed [6s Kc] and won 320 with Two pairs : Kings and Queens
Seat 2: _SKR (small blind) (button) showed [4h 8s] and lost with One pair : Queens


