Winamax Poker - Tournament "Expresso Nitro" buyIn: 1.86€ + 0.14€ level: 1 - HandId: #2696676232761704449-1-1675092923 - Holdem no limit (10/20) - 2023/01/30 15:35:23 UTC
Table: 'Expresso Nitro(627868863)#0' 3-max (real money) Seat #3 is the button
Seat 1: _SKR (300)
Seat 2: Bcharax07 (300)
Seat 3: Killme5 (300)
*** ANTE/BLINDS ***
_SKR posts small blind 10
Bcharax07 posts big blind 20
Dealt to _SKR [6h 5s]
*** PRE-FLOP *** 
Killme5 raises 280 to 300 and is all-in
_SKR folds
Bcharax07 calls 280 and is all-in
*** FLOP *** [3h 2h Qs]
*** TURN *** [3h 2h Qs][6s]
*** RIVER *** [3h 2h Qs 6s][9h]
*** SHOW DOWN ***
Bcharax07 shows [Ad Kc] (High card : Ace)
Killme5 shows [Ah 4h] (Flush Ace high)
Killme5 collected 610 from pot
*** SUMMARY ***
Total pot 610 | No rake
Board: [3h 2h Qs 6s 9h]
Seat 2: Bcharax07 (big blind) showed [Ad Kc] and lost with High card : Ace
Seat 3: Killme5 (button) showed [Ah 4h] and won 610 with Flush Ace high


Winamax Poker - Tournament "Expresso Nitro" buyIn: 1.86€ + 0.14€ level: 1 - HandId: #2696676232761704449-2-1675092941 - Holdem no limit (10/20) - 2023/01/30 15:35:41 UTC
Table: 'Expresso Nitro(627868863)#0' 3-max (real money) Seat #3 is the button
Seat 1: _SKR (290)
Seat 3: Killme5 (610)
*** ANTE/BLINDS ***
Killme5 posts small blind 10
_SKR posts big blind 20
Dealt to _SKR [Qc Jc]
*** PRE-FLOP *** 
Killme5 raises 40 to 60
_SKR calls 40
*** FLOP *** [7h 4h 2s]
_SKR checks
Killme5 checks
*** TURN *** [7h 4h 2s][Ad]
_SKR checks
Killme5 checks
*** RIVER *** [7h 4h 2s Ad][Ah]
_SKR checks
Killme5 bets 120
_SKR folds
Killme5 collected 240 from pot
*** SUMMARY ***
Total pot 240 | No rake
Board: [7h 4h 2s Ad Ah]
Seat 3: Killme5 (small blind) (button) won 240


Winamax Poker - Tournament "Expresso Nitro" buyIn: 1.86€ + 0.14€ level: 1 - HandId: #2696676232761704449-3-1675092962 - Holdem no limit (10/20) - 2023/01/30 15:36:02 UTC
Table: 'Expresso Nitro(627868863)#0' 3-max (real money) Seat #1 is the button
Seat 1: _SKR (230)
Seat 3: Killme5 (670)
*** ANTE/BLINDS ***
_SKR posts small blind 10
Killme5 posts big blind 20
Dealt to _SKR [9d Ac]
*** PRE-FLOP *** 
_SKR raises 210 to 230 and is all-in
Killme5 folds
_SKR collected 250 from pot
*** SUMMARY ***
Total pot 250 | No rake
Seat 1: _SKR (small blind) (button) won 250


Winamax Poker - Tournament "Expresso Nitro" buyIn: 1.86€ + 0.14€ level: 1 - HandId: #2696676232761704449-4-1675092967 - Holdem no limit (10/20) - 2023/01/30 15:36:07 UTC
Table: 'Expresso Nitro(627868863)#0' 3-max (real money) Seat #3 is the button
Seat 1: _SKR (250)
Seat 3: Killme5 (650)
*** ANTE/BLINDS ***
Killme5 posts small blind 10
_SKR posts big blind 20
Dealt to _SKR [Tc Ac]
*** PRE-FLOP *** 
Killme5 folds
_SKR collected 30 from pot
*** SUMMARY ***
Total pot 30 | No rake
Seat 1: _SKR (big blind) won 30


Winamax Poker - Tournament "Expresso Nitro" buyIn: 1.86€ + 0.14€ level: 1 - HandId: #2696676232761704449-5-1675092972 - Holdem no limit (10/20) - 2023/01/30 15:36:12 UTC
Table: 'Expresso Nitro(627868863)#0' 3-max (real money) Seat #1 is the button
Seat 1: _SKR (260)
Seat 3: Killme5 (640)
*** ANTE/BLINDS ***
_SKR posts small blind 10
Killme5 posts big blind 20
Dealt to _SKR [6s 8s]
*** PRE-FLOP *** 
_SKR raises 20 to 40
Killme5 folds
_SKR collected 60 from pot
*** SUMMARY ***
Total pot 60 | No rake
Seat 1: _SKR (small blind) (button) won 60


Winamax Poker - Tournament "Expresso Nitro" buyIn: 1.86€ + 0.14€ level: 2 - HandId: #2696676232761704449-6-1675092980 - Holdem no limit (15/30) - 2023/01/30 15:36:20 UTC
Table: 'Expresso Nitro(627868863)#0' 3-max (real money) Seat #3 is the button
Seat 1: _SKR (280)
Seat 3: Killme5 (620)
*** ANTE/BLINDS ***
Killme5 posts small blind 15
_SKR posts big blind 30
Dealt to _SKR [4c 7s]
*** PRE-FLOP *** 
Killme5 folds
_SKR collected 45 from pot
*** SUMMARY ***
Total pot 45 | No rake
Seat 1: _SKR (big blind) won 45


Winamax Poker - Tournament "Expresso Nitro" buyIn: 1.86€ + 0.14€ level: 2 - HandId: #2696676232761704449-7-1675092983 - Holdem no limit (15/30) - 2023/01/30 15:36:23 UTC
Table: 'Expresso Nitro(627868863)#0' 3-max (real money) Seat #1 is the button
Seat 1: _SKR (295)
Seat 3: Killme5 (605)
*** ANTE/BLINDS ***
_SKR posts small blind 15
Killme5 posts big blind 30
Dealt to _SKR [Kh 6d]
*** PRE-FLOP *** 
_SKR raises 265 to 295 and is all-in
Killme5 calls 265
*** FLOP *** [Kc 4d 8h]
*** TURN *** [Kc 4d 8h][Ad]
*** RIVER *** [Kc 4d 8h Ad][Ks]
*** SHOW DOWN ***
_SKR shows [Kh 6d] (Trips of Kings)
Killme5 shows [Kd 7h] (Trips of Kings)
Killme5 collected 295 from pot
_SKR collected 295 from pot
*** SUMMARY ***
Total pot 590 | No rake
Board: [Kc 4d 8h Ad Ks]
Seat 1: _SKR (small blind) (button) showed [Kh 6d] and won 295 with Trips of Kings
Seat 3: Killme5 (big blind) showed [Kd 7h] and won 295 with Trips of Kings


Winamax Poker - Tournament "Expresso Nitro" buyIn: 1.86€ + 0.14€ level: 2 - HandId: #2696676232761704449-8-1675092997 - Holdem no limit (15/30) - 2023/01/30 15:36:37 UTC
Table: 'Expresso Nitro(627868863)#0' 3-max (real money) Seat #3 is the button
Seat 1: _SKR (295)
Seat 3: Killme5 (605)
*** ANTE/BLINDS ***
Killme5 posts small blind 15
_SKR posts big blind 30
Dealt to _SKR [3h Qc]
*** PRE-FLOP *** 
Killme5 raises 575 to 605 and is all-in
_SKR folds
Killme5 collected 635 from pot
*** SUMMARY ***
Total pot 635 | No rake
Seat 3: Killme5 (small blind) (button) won 635


Winamax Poker - Tournament "Expresso Nitro" buyIn: 1.86€ + 0.14€ level: 2 - HandId: #2696676232761704449-9-1675093012 - Holdem no limit (15/30) - 2023/01/30 15:36:52 UTC
Table: 'Expresso Nitro(627868863)#0' 3-max (real money) Seat #1 is the button
Seat 1: _SKR (265)
Seat 3: Killme5 (635)
*** ANTE/BLINDS ***
_SKR posts small blind 15
Killme5 posts big blind 30
Dealt to _SKR [4d 9c]
*** PRE-FLOP *** 
_SKR folds
Killme5 collected 45 from pot
*** SUMMARY ***
Total pot 45 | No rake
Seat 3: Killme5 (big blind) won 45


Winamax Poker - Tournament "Expresso Nitro" buyIn: 1.86€ + 0.14€ level: 2 - HandId: #2696676232761704449-10-1675093017 - Holdem no limit (15/30) - 2023/01/30 15:36:57 UTC
Table: 'Expresso Nitro(627868863)#0' 3-max (real money) Seat #3 is the button
Seat 1: _SKR (250)
Seat 3: Killme5 (650)
*** ANTE/BLINDS ***
Killme5 posts small blind 15
_SKR posts big blind 30
Dealt to _SKR [6s Jc]
*** PRE-FLOP *** 
Killme5 raises 620 to 650 and is all-in
_SKR folds
Killme5 collected 680 from pot
*** SUMMARY ***
Total pot 680 | No rake
Seat 3: Killme5 (small blind) (button) won 680


Winamax Poker - Tournament "Expresso Nitro" buyIn: 1.86€ + 0.14€ level: 2 - HandId: #2696676232761704449-11-1675093031 - Holdem no limit (15/30) - 2023/01/30 15:37:11 UTC
Table: 'Expresso Nitro(627868863)#0' 3-max (real money) Seat #1 is the button
Seat 1: _SKR (220)
Seat 3: Killme5 (680)
*** ANTE/BLINDS ***
_SKR posts small blind 15
Killme5 posts big blind 30
Dealt to _SKR [7h 6d]
*** PRE-FLOP *** 
_SKR folds
Killme5 collected 45 from pot
*** SUMMARY ***
Total pot 45 | No rake
Seat 3: Killme5 (big blind) won 45


Winamax Poker - Tournament "Expresso Nitro" buyIn: 1.86€ + 0.14€ level: 2 - HandId: #2696676232761704449-12-1675093037 - Holdem no limit (15/30) - 2023/01/30 15:37:17 UTC
Table: 'Expresso Nitro(627868863)#0' 3-max (real money) Seat #3 is the button
Seat 1: _SKR (205)
Seat 3: Killme5 (695)
*** ANTE/BLINDS ***
Killme5 posts small blind 15
_SKR posts big blind 30
Dealt to _SKR [3h 6d]
*** PRE-FLOP *** 
Killme5 raises 665 to 695 and is all-in
_SKR folds
Killme5 collected 725 from pot
*** SUMMARY ***
Total pot 725 | No rake
Seat 3: Killme5 (small blind) (button) won 725


Winamax Poker - Tournament "Expresso Nitro" buyIn: 1.86€ + 0.14€ level: 3 - HandId: #2696676232761704449-13-1675093044 - Holdem no limit (20/40) - 2023/01/30 15:37:24 UTC
Table: 'Expresso Nitro(627868863)#0' 3-max (real money) Seat #1 is the button
Seat 1: _SKR (175)
Seat 3: Killme5 (725)
*** ANTE/BLINDS ***
_SKR posts small blind 20
Killme5 posts big blind 40
Dealt to _SKR [Td 9d]
*** PRE-FLOP *** 
_SKR raises 135 to 175 and is all-in
Killme5 calls 135
*** FLOP *** [2d 3c 8d]
*** TURN *** [2d 3c 8d][8c]
*** RIVER *** [2d 3c 8d 8c][5c]
*** SHOW DOWN ***
_SKR shows [Td 9d] (One pair : 8)
Killme5 shows [As 9s] (One pair : 8)
Killme5 collected 350 from pot
*** SUMMARY ***
Total pot 350 | No rake
Board: [2d 3c 8d 8c 5c]
Seat 1: _SKR (small blind) (button) showed [Td 9d] and lost with One pair : 8
Seat 3: Killme5 (big blind) showed [As 9s] and won 350 with One pair : 8


