Winamax Poker - Tournament "Expresso Nitro" buyIn: 1.86€ + 0.14€ level: 1 - HandId: #2698278285627883521-1-1675188591 - Holdem no limit (10/20) - 2023/01/31 18:09:51 UTC
Table: 'Expresso Nitro(628241870)#0' 3-max (real money) Seat #3 is the button
Seat 1: cricri18001 (300)
Seat 2: Darama (300)
Seat 3: _SKR (300)
*** ANTE/BLINDS ***
cricri18001 posts small blind 10
Darama posts big blind 20
Dealt to _SKR [Qc 5s]
*** PRE-FLOP *** 
_SKR folds
cricri18001 folds
Darama collected 30 from pot
*** SUMMARY ***
Total pot 30 | No rake
Seat 2: Darama (big blind) won 30


Winamax Poker - Tournament "Expresso Nitro" buyIn: 1.86€ + 0.14€ level: 1 - HandId: #2698278285627883521-2-1675188608 - Holdem no limit (10/20) - 2023/01/31 18:10:08 UTC
Table: 'Expresso Nitro(628241870)#0' 3-max (real money) Seat #1 is the button
Seat 1: cricri18001 (290)
Seat 2: Darama (310)
Seat 3: _SKR (300)
*** ANTE/BLINDS ***
Darama posts small blind 10
_SKR posts big blind 20
Dealt to _SKR [3h 4s]
*** PRE-FLOP *** 
cricri18001 raises 20 to 40
Darama folds
_SKR folds
cricri18001 collected 70 from pot
*** SUMMARY ***
Total pot 70 | No rake
Seat 1: cricri18001 (button) won 70


Winamax Poker - Tournament "Expresso Nitro" buyIn: 1.86€ + 0.14€ level: 1 - HandId: #2698278285627883521-3-1675188629 - Holdem no limit (10/20) - 2023/01/31 18:10:29 UTC
Table: 'Expresso Nitro(628241870)#0' 3-max (real money) Seat #2 is the button
Seat 1: cricri18001 (320)
Seat 2: Darama (300)
Seat 3: _SKR (280)
*** ANTE/BLINDS ***
_SKR posts small blind 10
cricri18001 posts big blind 20
Dealt to _SKR [Ah 8h]
*** PRE-FLOP *** 
Darama folds
_SKR raises 260 to 280 and is all-in
cricri18001 raises 40 to 320 and is all-in
*** FLOP *** [3c 5d 2h]
*** TURN *** [3c 5d 2h][7c]
*** RIVER *** [3c 5d 2h 7c][Ks]
*** SHOW DOWN ***
cricri18001 shows [6s Jc] (High card : King)
_SKR shows [Ah 8h] (High card : Ace)
_SKR collected 560 from main pot
cricri18001 collected 40 from side pot 1
*** SUMMARY ***
Total pot 600 | No rake
Board: [3c 5d 2h 7c Ks]
Seat 1: cricri18001 (big blind) showed [6s Jc] and won 40 with High card : King
Seat 3: _SKR (small blind) showed [Ah 8h] and won 560 with High card : Ace


Winamax Poker - Tournament "Expresso Nitro" buyIn: 1.86€ + 0.14€ level: 1 - HandId: #2698278285627883521-4-1675188644 - Holdem no limit (10/20) - 2023/01/31 18:10:44 UTC
Table: 'Expresso Nitro(628241870)#0' 3-max (real money) Seat #3 is the button
Seat 1: cricri18001 (40)
Seat 2: Darama (300)
Seat 3: _SKR (560)
*** ANTE/BLINDS ***
cricri18001 posts small blind 10
Darama posts big blind 20
Dealt to _SKR [9h 7c]
*** PRE-FLOP *** 
_SKR folds
cricri18001 raises 20 to 40 and is all-in
Darama calls 20
*** FLOP *** [Th 6s Js]
*** TURN *** [Th 6s Js][4d]
*** RIVER *** [Th 6s Js 4d][4c]
*** SHOW DOWN ***
cricri18001 shows [3c Kh] (One pair : 4)
Darama shows [Jc 9s] (Two pairs : Jacks and 4)
Darama collected 80 from pot
*** SUMMARY ***
Total pot 80 | No rake
Board: [Th 6s Js 4d 4c]
Seat 1: cricri18001 (small blind) showed [3c Kh] and lost with One pair : 4
Seat 2: Darama (big blind) showed [Jc 9s] and won 80 with Two pairs : Jacks and 4


Winamax Poker - Tournament "Expresso Nitro" buyIn: 1.86€ + 0.14€ level: 2 - HandId: #2698278285627883521-5-1675188659 - Holdem no limit (15/30) - 2023/01/31 18:10:59 UTC
Table: 'Expresso Nitro(628241870)#0' 3-max (real money) Seat #2 is the button
Seat 2: Darama (340)
Seat 3: _SKR (560)
*** ANTE/BLINDS ***
Darama posts small blind 15
_SKR posts big blind 30
Dealt to _SKR [Qc Td]
*** PRE-FLOP *** 
Darama raises 310 to 340 and is all-in
_SKR folds
Darama collected 370 from pot
*** SUMMARY ***
Total pot 370 | No rake
Seat 2: Darama (small blind) (button) won 370


Winamax Poker - Tournament "Expresso Nitro" buyIn: 1.86€ + 0.14€ level: 2 - HandId: #2698278285627883521-6-1675188667 - Holdem no limit (15/30) - 2023/01/31 18:11:07 UTC
Table: 'Expresso Nitro(628241870)#0' 3-max (real money) Seat #3 is the button
Seat 2: Darama (370)
Seat 3: _SKR (530)
*** ANTE/BLINDS ***
_SKR posts small blind 15
Darama posts big blind 30
Dealt to _SKR [Ad Kd]
*** PRE-FLOP *** 
_SKR raises 500 to 530 and is all-in
Darama folds
_SKR collected 560 from pot
*** SUMMARY ***
Total pot 560 | No rake
Seat 3: _SKR (small blind) (button) won 560


Winamax Poker - Tournament "Expresso Nitro" buyIn: 1.86€ + 0.14€ level: 2 - HandId: #2698278285627883521-7-1675188676 - Holdem no limit (15/30) - 2023/01/31 18:11:16 UTC
Table: 'Expresso Nitro(628241870)#0' 3-max (real money) Seat #2 is the button
Seat 2: Darama (340)
Seat 3: _SKR (560)
*** ANTE/BLINDS ***
Darama posts small blind 15
_SKR posts big blind 30
Dealt to _SKR [Qs Ac]
*** PRE-FLOP *** 
Darama calls 15
_SKR raises 530 to 560 and is all-in
Darama folds
_SKR collected 590 from pot
*** SUMMARY ***
Total pot 590 | No rake
Seat 3: _SKR (big blind) won 590


Winamax Poker - Tournament "Expresso Nitro" buyIn: 1.86€ + 0.14€ level: 2 - HandId: #2698278285627883521-8-1675188682 - Holdem no limit (15/30) - 2023/01/31 18:11:22 UTC
Table: 'Expresso Nitro(628241870)#0' 3-max (real money) Seat #3 is the button
Seat 2: Darama (310)
Seat 3: _SKR (590)
*** ANTE/BLINDS ***
_SKR posts small blind 15
Darama posts big blind 30
Dealt to _SKR [8s 2h]
*** PRE-FLOP *** 
_SKR folds
Darama collected 45 from pot
*** SUMMARY ***
Total pot 45 | No rake
Seat 2: Darama (big blind) won 45


Winamax Poker - Tournament "Expresso Nitro" buyIn: 1.86€ + 0.14€ level: 2 - HandId: #2698278285627883521-9-1675188687 - Holdem no limit (15/30) - 2023/01/31 18:11:27 UTC
Table: 'Expresso Nitro(628241870)#0' 3-max (real money) Seat #2 is the button
Seat 2: Darama (325)
Seat 3: _SKR (575)
*** ANTE/BLINDS ***
Darama posts small blind 15
_SKR posts big blind 30
Dealt to _SKR [8d Kh]
*** PRE-FLOP *** 
Darama folds
_SKR collected 45 from pot
*** SUMMARY ***
Total pot 45 | No rake
Seat 3: _SKR (big blind) won 45


Winamax Poker - Tournament "Expresso Nitro" buyIn: 1.86€ + 0.14€ level: 2 - HandId: #2698278285627883521-10-1675188691 - Holdem no limit (15/30) - 2023/01/31 18:11:31 UTC
Table: 'Expresso Nitro(628241870)#0' 3-max (real money) Seat #3 is the button
Seat 2: Darama (310)
Seat 3: _SKR (590)
*** ANTE/BLINDS ***
_SKR posts small blind 15
Darama posts big blind 30
Dealt to _SKR [4s 5s]
*** PRE-FLOP *** 
_SKR folds
Darama collected 45 from pot
*** SUMMARY ***
Total pot 45 | No rake
Seat 2: Darama (big blind) won 45


Winamax Poker - Tournament "Expresso Nitro" buyIn: 1.86€ + 0.14€ level: 2 - HandId: #2698278285627883521-11-1675188695 - Holdem no limit (15/30) - 2023/01/31 18:11:35 UTC
Table: 'Expresso Nitro(628241870)#0' 3-max (real money) Seat #2 is the button
Seat 2: Darama (325)
Seat 3: _SKR (575)
*** ANTE/BLINDS ***
Darama posts small blind 15
_SKR posts big blind 30
Dealt to _SKR [2h 6h]
*** PRE-FLOP *** 
Darama raises 295 to 325 and is all-in
_SKR folds
Darama collected 355 from pot
*** SUMMARY ***
Total pot 355 | No rake
Seat 2: Darama (small blind) (button) won 355


Winamax Poker - Tournament "Expresso Nitro" buyIn: 1.86€ + 0.14€ level: 2 - HandId: #2698278285627883521-12-1675188702 - Holdem no limit (15/30) - 2023/01/31 18:11:42 UTC
Table: 'Expresso Nitro(628241870)#0' 3-max (real money) Seat #3 is the button
Seat 2: Darama (355)
Seat 3: _SKR (545)
*** ANTE/BLINDS ***
_SKR posts small blind 15
Darama posts big blind 30
Dealt to _SKR [7h 3h]
*** PRE-FLOP *** 
_SKR folds
Darama collected 45 from pot
*** SUMMARY ***
Total pot 45 | No rake
Seat 2: Darama (big blind) won 45


Winamax Poker - Tournament "Expresso Nitro" buyIn: 1.86€ + 0.14€ level: 2 - HandId: #2698278285627883521-13-1675188706 - Holdem no limit (15/30) - 2023/01/31 18:11:46 UTC
Table: 'Expresso Nitro(628241870)#0' 3-max (real money) Seat #2 is the button
Seat 2: Darama (370)
Seat 3: _SKR (530)
*** ANTE/BLINDS ***
Darama posts small blind 15
_SKR posts big blind 30
Dealt to _SKR [6d 7s]
*** PRE-FLOP *** 
Darama folds
_SKR collected 45 from pot
*** SUMMARY ***
Total pot 45 | No rake
Seat 3: _SKR (big blind) won 45


Winamax Poker - Tournament "Expresso Nitro" buyIn: 1.86€ + 0.14€ level: 3 - HandId: #2698278285627883521-14-1675188710 - Holdem no limit (20/40) - 2023/01/31 18:11:50 UTC
Table: 'Expresso Nitro(628241870)#0' 3-max (real money) Seat #3 is the button
Seat 2: Darama (355)
Seat 3: _SKR (545)
*** ANTE/BLINDS ***
_SKR posts small blind 20
Darama posts big blind 40
Dealt to _SKR [9s 8d]
*** PRE-FLOP *** 
_SKR folds
Darama collected 60 from pot
*** SUMMARY ***
Total pot 60 | No rake
Seat 2: Darama (big blind) won 60


Winamax Poker - Tournament "Expresso Nitro" buyIn: 1.86€ + 0.14€ level: 3 - HandId: #2698278285627883521-15-1675188718 - Holdem no limit (20/40) - 2023/01/31 18:11:58 UTC
Table: 'Expresso Nitro(628241870)#0' 3-max (real money) Seat #2 is the button
Seat 2: Darama (375)
Seat 3: _SKR (525)
*** ANTE/BLINDS ***
Darama posts small blind 20
_SKR posts big blind 40
Dealt to _SKR [Tc 3s]
*** PRE-FLOP *** 
Darama folds
_SKR collected 60 from pot
*** SUMMARY ***
Total pot 60 | No rake
Seat 3: _SKR (big blind) won 60


Winamax Poker - Tournament "Expresso Nitro" buyIn: 1.86€ + 0.14€ level: 3 - HandId: #2698278285627883521-16-1675188723 - Holdem no limit (20/40) - 2023/01/31 18:12:03 UTC
Table: 'Expresso Nitro(628241870)#0' 3-max (real money) Seat #3 is the button
Seat 2: Darama (355)
Seat 3: _SKR (545)
*** ANTE/BLINDS ***
_SKR posts small blind 20
Darama posts big blind 40
Dealt to _SKR [9c 7h]
*** PRE-FLOP *** 
_SKR folds
Darama collected 60 from pot
*** SUMMARY ***
Total pot 60 | No rake
Seat 2: Darama (big blind) won 60


Winamax Poker - Tournament "Expresso Nitro" buyIn: 1.86€ + 0.14€ level: 3 - HandId: #2698278285627883521-17-1675188728 - Holdem no limit (20/40) - 2023/01/31 18:12:08 UTC
Table: 'Expresso Nitro(628241870)#0' 3-max (real money) Seat #2 is the button
Seat 2: Darama (375)
Seat 3: _SKR (525)
*** ANTE/BLINDS ***
Darama posts small blind 20
_SKR posts big blind 40
Dealt to _SKR [As Td]
*** PRE-FLOP *** 
Darama folds
_SKR collected 60 from pot
*** SUMMARY ***
Total pot 60 | No rake
Seat 3: _SKR (big blind) won 60


Winamax Poker - Tournament "Expresso Nitro" buyIn: 1.86€ + 0.14€ level: 3 - HandId: #2698278285627883521-18-1675188744 - Holdem no limit (20/40) - 2023/01/31 18:12:24 UTC
Table: 'Expresso Nitro(628241870)#0' 3-max (real money) Seat #3 is the button
Seat 2: Darama (355)
Seat 3: _SKR (545)
*** ANTE/BLINDS ***
_SKR posts small blind 20
Darama posts big blind 40
Dealt to _SKR [9h Js]
*** PRE-FLOP *** 
_SKR raises 505 to 545 and is all-in
Darama folds
_SKR collected 585 from pot
*** SUMMARY ***
Total pot 585 | No rake
Seat 3: _SKR (small blind) (button) won 585


Winamax Poker - Tournament "Expresso Nitro" buyIn: 1.86€ + 0.14€ level: 3 - HandId: #2698278285627883521-19-1675188749 - Holdem no limit (20/40) - 2023/01/31 18:12:29 UTC
Table: 'Expresso Nitro(628241870)#0' 3-max (real money) Seat #2 is the button
Seat 2: Darama (315)
Seat 3: _SKR (585)
*** ANTE/BLINDS ***
Darama posts small blind 20
_SKR posts big blind 40
Dealt to _SKR [7d Jc]
*** PRE-FLOP *** 
Darama folds
_SKR collected 60 from pot
*** SUMMARY ***
Total pot 60 | No rake
Seat 3: _SKR (big blind) won 60


Winamax Poker - Tournament "Expresso Nitro" buyIn: 1.86€ + 0.14€ level: 3 - HandId: #2698278285627883521-20-1675188753 - Holdem no limit (20/40) - 2023/01/31 18:12:33 UTC
Table: 'Expresso Nitro(628241870)#0' 3-max (real money) Seat #3 is the button
Seat 2: Darama (295)
Seat 3: _SKR (605)
*** ANTE/BLINDS ***
_SKR posts small blind 20
Darama posts big blind 40
Dealt to _SKR [Jh 2s]
*** PRE-FLOP *** 
_SKR folds
Darama collected 60 from pot
*** SUMMARY ***
Total pot 60 | No rake
Seat 2: Darama (big blind) won 60


Winamax Poker - Tournament "Expresso Nitro" buyIn: 1.86€ + 0.14€ level: 3 - HandId: #2698278285627883521-21-1675188757 - Holdem no limit (20/40) - 2023/01/31 18:12:37 UTC
Table: 'Expresso Nitro(628241870)#0' 3-max (real money) Seat #2 is the button
Seat 2: Darama (315)
Seat 3: _SKR (585)
*** ANTE/BLINDS ***
Darama posts small blind 20
_SKR posts big blind 40
Dealt to _SKR [Qd 6h]
*** PRE-FLOP *** 
Darama folds
_SKR collected 60 from pot
*** SUMMARY ***
Total pot 60 | No rake
Seat 3: _SKR (big blind) won 60


Winamax Poker - Tournament "Expresso Nitro" buyIn: 1.86€ + 0.14€ level: 3 - HandId: #2698278285627883521-22-1675188760 - Holdem no limit (20/40) - 2023/01/31 18:12:40 UTC
Table: 'Expresso Nitro(628241870)#0' 3-max (real money) Seat #3 is the button
Seat 2: Darama (295)
Seat 3: _SKR (605)
*** ANTE/BLINDS ***
_SKR posts small blind 20
Darama posts big blind 40
Dealt to _SKR [3s 8c]
*** PRE-FLOP *** 
_SKR folds
Darama collected 60 from pot
*** SUMMARY ***
Total pot 60 | No rake
Seat 2: Darama (big blind) won 60


Winamax Poker - Tournament "Expresso Nitro" buyIn: 1.86€ + 0.14€ level: 3 - HandId: #2698278285627883521-23-1675188764 - Holdem no limit (20/40) - 2023/01/31 18:12:44 UTC
Table: 'Expresso Nitro(628241870)#0' 3-max (real money) Seat #2 is the button
Seat 2: Darama (315)
Seat 3: _SKR (585)
*** ANTE/BLINDS ***
Darama posts small blind 20
_SKR posts big blind 40
Dealt to _SKR [Ac 3h]
*** PRE-FLOP *** 
Darama calls 20
_SKR raises 545 to 585 and is all-in
Darama calls 275 and is all-in
*** FLOP *** [Qh Kh Jd]
*** TURN *** [Qh Kh Jd][Ks]
*** RIVER *** [Qh Kh Jd Ks][4h]
*** SHOW DOWN ***
Darama shows [Kd 5d] (Trips of Kings)
_SKR shows [Ac 3h] (One pair : Kings)
_SKR collected 270 from side pot 1
Darama collected 630 from main pot
*** SUMMARY ***
Total pot 900 | No rake
Board: [Qh Kh Jd Ks 4h]
Seat 2: Darama (small blind) (button) showed [Kd 5d] and won 630 with Trips of Kings
Seat 3: _SKR (big blind) showed [Ac 3h] and won 270 with One pair : Kings


Winamax Poker - Tournament "Expresso Nitro" buyIn: 1.86€ + 0.14€ level: 4 - HandId: #2698278285627883521-24-1675188777 - Holdem no limit (30/60) - 2023/01/31 18:12:57 UTC
Table: 'Expresso Nitro(628241870)#0' 3-max (real money) Seat #3 is the button
Seat 2: Darama (630)
Seat 3: _SKR (270)
*** ANTE/BLINDS ***
_SKR posts small blind 30
Darama posts big blind 60
Dealt to _SKR [Jc Tc]
*** PRE-FLOP *** 
_SKR raises 210 to 270 and is all-in
Darama calls 210
*** FLOP *** [Kd Js 5d]
*** TURN *** [Kd Js 5d][Kh]
*** RIVER *** [Kd Js 5d Kh][6c]
*** SHOW DOWN ***
_SKR shows [Jc Tc] (Two pairs : Kings and Jacks)
Darama shows [6d Kc] (Full of Kings and 6)
Darama collected 540 from pot
*** SUMMARY ***
Total pot 540 | No rake
Board: [Kd Js 5d Kh 6c]
Seat 2: Darama (big blind) showed [6d Kc] and won 540 with Full of Kings and 6
Seat 3: _SKR (small blind) (button) showed [Jc Tc] and lost with Two pairs : Kings and Jacks


