Winamax Poker - Tournament "Expresso Nitro" buyIn: 0.93€ + 0.07€ level: 1 - HandId: #2671023346585436161-1-1673527130 - Holdem no limit (10/20) - 2023/01/12 12:38:50 UTC
Table: 'Expresso Nitro(621896085)#0' 3-max (real money) Seat #2 is the button
Seat 1: Dam29610 (300)
Seat 2: Momobasse (300)
Seat 3: _SKR (300)
*** ANTE/BLINDS ***
_SKR posts small blind 10
Dam29610 posts big blind 20
Dealt to _SKR [Kd Th]
*** PRE-FLOP *** 
Momobasse calls 20
_SKR raises 280 to 300 and is all-in
Dam29610 folds
Momobasse calls 280 and is all-in
*** FLOP *** [2d Qs Qc]
*** TURN *** [2d Qs Qc][5s]
*** RIVER *** [2d Qs Qc 5s][Qd]
*** SHOW DOWN ***
Momobasse shows [Kc 4h] (Trips of Queens)
_SKR shows [Kd Th] (Trips of Queens)
_SKR collected 620 from pot
*** SUMMARY ***
Total pot 620 | No rake
Board: [2d Qs Qc 5s Qd]
Seat 2: Momobasse (button) showed [Kc 4h] and lost with Trips of Queens
Seat 3: _SKR (small blind) showed [Kd Th] and won 620 with Trips of Queens


Winamax Poker - Tournament "Expresso Nitro" buyIn: 0.93€ + 0.07€ level: 1 - HandId: #2671023346585436161-2-1673527148 - Holdem no limit (10/20) - 2023/01/12 12:39:08 UTC
Table: 'Expresso Nitro(621896085)#0' 3-max (real money) Seat #1 is the button
Seat 1: Dam29610 (280)
Seat 3: _SKR (620)
*** ANTE/BLINDS ***
Dam29610 posts small blind 10
_SKR posts big blind 20
Dealt to _SKR [Js 7s]
*** PRE-FLOP *** 
Dam29610 raises 40 to 60
_SKR calls 40
*** FLOP *** [2c Kc 5d]
_SKR checks
Dam29610 checks
*** TURN *** [2c Kc 5d][Kd]
_SKR checks
Dam29610 checks
*** RIVER *** [2c Kc 5d Kd][2d]
_SKR checks
Dam29610 checks
*** SHOW DOWN ***
_SKR shows [Js 7s] (Two pairs : Kings and 2)
Dam29610 shows [As 4c] (Two pairs : Kings and 2)
Dam29610 collected 120 from pot
*** SUMMARY ***
Total pot 120 | No rake
Board: [2c Kc 5d Kd 2d]
Seat 1: Dam29610 (small blind) (button) showed [As 4c] and won 120 with Two pairs : Kings and 2
Seat 3: _SKR (big blind) showed [Js 7s] and lost with Two pairs : Kings and 2


Winamax Poker - Tournament "Expresso Nitro" buyIn: 0.93€ + 0.07€ level: 1 - HandId: #2671023346585436161-3-1673527168 - Holdem no limit (10/20) - 2023/01/12 12:39:28 UTC
Table: 'Expresso Nitro(621896085)#0' 3-max (real money) Seat #3 is the button
Seat 1: Dam29610 (340)
Seat 3: _SKR (560)
*** ANTE/BLINDS ***
_SKR posts small blind 10
Dam29610 posts big blind 20
Dealt to _SKR [Ad 5s]
*** PRE-FLOP *** 
_SKR raises 540 to 560 and is all-in
Dam29610 calls 320 and is all-in
*** FLOP *** [Kd Jc 7c]
*** TURN *** [Kd Jc 7c][Jd]
*** RIVER *** [Kd Jc 7c Jd][8c]
*** SHOW DOWN ***
Dam29610 shows [4c Kh] (Two pairs : Kings and Jacks)
_SKR shows [Ad 5s] (One pair : Jacks)
_SKR collected 220 from side pot 1
Dam29610 collected 680 from main pot
*** SUMMARY ***
Total pot 900 | No rake
Board: [Kd Jc 7c Jd 8c]
Seat 1: Dam29610 (big blind) showed [4c Kh] and won 680 with Two pairs : Kings and Jacks
Seat 3: _SKR (small blind) (button) showed [Ad 5s] and won 220 with One pair : Jacks


Winamax Poker - Tournament "Expresso Nitro" buyIn: 0.93€ + 0.07€ level: 1 - HandId: #2671023346585436161-4-1673527181 - Holdem no limit (10/20) - 2023/01/12 12:39:41 UTC
Table: 'Expresso Nitro(621896085)#0' 3-max (real money) Seat #1 is the button
Seat 1: Dam29610 (680)
Seat 3: _SKR (220)
*** ANTE/BLINDS ***
Dam29610 posts small blind 10
_SKR posts big blind 20
Dealt to _SKR [Ts Td]
*** PRE-FLOP *** 
Dam29610 calls 10
_SKR raises 200 to 220 and is all-in
Dam29610 calls 200
*** FLOP *** [5h 5s 6c]
*** TURN *** [5h 5s 6c][7d]
*** RIVER *** [5h 5s 6c 7d][8h]
*** SHOW DOWN ***
_SKR shows [Ts Td] (Two pairs : Tens and 5)
Dam29610 shows [As 9s] (Straight 9 high)
Dam29610 collected 440 from pot
*** SUMMARY ***
Total pot 440 | No rake
Board: [5h 5s 6c 7d 8h]
Seat 1: Dam29610 (small blind) (button) showed [As 9s] and won 440 with Straight 9 high
Seat 3: _SKR (big blind) showed [Ts Td] and lost with Two pairs : Tens and 5


