Winamax Poker - Tournament "Expresso Nitro" buyIn: 0.93€ + 0.07€ level: 1 - HandId: #2717232869658329089-1-1676213147 - Holdem no limit (10/20) - 2023/02/12 14:45:47 UTC
Table: 'Expresso Nitro(632655078)#0' 3-max (real money) Seat #2 is the button
Seat 1: Lynxio13 (300)
Seat 2: Bluemoon2b (300)
Seat 3: _SKR (300)
*** ANTE/BLINDS ***
_SKR posts small blind 10
Lynxio13 posts big blind 20
Dealt to _SKR [Qh 8s]
*** PRE-FLOP *** 
Bluemoon2b calls 20
_SKR folds
Lynxio13 raises 50 to 70
Bluemoon2b calls 50
*** FLOP *** [7c 4s 5d]
Lynxio13 bets 230 and is all-in
Bluemoon2b calls 230 and is all-in
*** TURN *** [7c 4s 5d][5s]
*** RIVER *** [7c 4s 5d 5s][2c]
*** SHOW DOWN ***
Lynxio13 shows [Kd As] (One pair : 5)
Bluemoon2b shows [2h 2d] (Full of 2 and 5)
Bluemoon2b collected 610 from pot
*** SUMMARY ***
Total pot 610 | No rake
Board: [7c 4s 5d 5s 2c]
Seat 1: Lynxio13 (big blind) showed [Kd As] and lost with One pair : 5
Seat 2: Bluemoon2b (button) showed [2h 2d] and won 610 with Full of 2 and 5


Winamax Poker - Tournament "Expresso Nitro" buyIn: 0.93€ + 0.07€ level: 1 - HandId: #2717232869658329089-2-1676213172 - Holdem no limit (10/20) - 2023/02/12 14:46:12 UTC
Table: 'Expresso Nitro(632655078)#0' 3-max (real money) Seat #2 is the button
Seat 2: Bluemoon2b (610)
Seat 3: _SKR (290)
*** ANTE/BLINDS ***
Bluemoon2b posts small blind 10
_SKR posts big blind 20
Dealt to _SKR [6d Qh]
*** PRE-FLOP *** 
Bluemoon2b raises 20 to 40
_SKR folds
Bluemoon2b collected 60 from pot
*** SUMMARY ***
Total pot 60 | No rake
Seat 2: Bluemoon2b (small blind) (button) won 60


Winamax Poker - Tournament "Expresso Nitro" buyIn: 0.93€ + 0.07€ level: 1 - HandId: #2717232869658329089-3-1676213178 - Holdem no limit (10/20) - 2023/02/12 14:46:18 UTC
Table: 'Expresso Nitro(632655078)#0' 3-max (real money) Seat #3 is the button
Seat 2: Bluemoon2b (630)
Seat 3: _SKR (270)
*** ANTE/BLINDS ***
_SKR posts small blind 10
Bluemoon2b posts big blind 20
Dealt to _SKR [7h Qd]
*** PRE-FLOP *** 
_SKR folds
Bluemoon2b collected 30 from pot
*** SUMMARY ***
Total pot 30 | No rake
Seat 2: Bluemoon2b (big blind) won 30


Winamax Poker - Tournament "Expresso Nitro" buyIn: 0.93€ + 0.07€ level: 1 - HandId: #2717232869658329089-4-1676213182 - Holdem no limit (10/20) - 2023/02/12 14:46:22 UTC
Table: 'Expresso Nitro(632655078)#0' 3-max (real money) Seat #2 is the button
Seat 2: Bluemoon2b (640)
Seat 3: _SKR (260)
*** ANTE/BLINDS ***
Bluemoon2b posts small blind 10
_SKR posts big blind 20
Dealt to _SKR [Jd Jc]
*** PRE-FLOP *** 
Bluemoon2b calls 10
_SKR raises 30 to 50
Bluemoon2b calls 30
*** FLOP *** [4h 3c Qh]
_SKR bets 35
Bluemoon2b folds
_SKR collected 135 from pot
*** SUMMARY ***
Total pot 135 | No rake
Board: [4h 3c Qh]
Seat 3: _SKR (big blind) won 135


Winamax Poker - Tournament "Expresso Nitro" buyIn: 0.93€ + 0.07€ level: 2 - HandId: #2717232869658329089-5-1676213203 - Holdem no limit (15/30) - 2023/02/12 14:46:43 UTC
Table: 'Expresso Nitro(632655078)#0' 3-max (real money) Seat #3 is the button
Seat 2: Bluemoon2b (590)
Seat 3: _SKR (310)
*** ANTE/BLINDS ***
_SKR posts small blind 15
Bluemoon2b posts big blind 30
Dealt to _SKR [Kd 2h]
*** PRE-FLOP *** 
_SKR raises 280 to 310 and is all-in
Bluemoon2b folds
_SKR collected 340 from pot
*** SUMMARY ***
Total pot 340 | No rake
Seat 3: _SKR (small blind) (button) won 340


Winamax Poker - Tournament "Expresso Nitro" buyIn: 0.93€ + 0.07€ level: 2 - HandId: #2717232869658329089-6-1676213210 - Holdem no limit (15/30) - 2023/02/12 14:46:50 UTC
Table: 'Expresso Nitro(632655078)#0' 3-max (real money) Seat #2 is the button
Seat 2: Bluemoon2b (560)
Seat 3: _SKR (340)
*** ANTE/BLINDS ***
Bluemoon2b posts small blind 15
_SKR posts big blind 30
Dealt to _SKR [Js Ts]
*** PRE-FLOP *** 
Bluemoon2b calls 15
_SKR checks
*** FLOP *** [6s 4s Ah]
_SKR checks
Bluemoon2b bets 30
_SKR raises 280 to 310 and is all-in
Bluemoon2b folds
_SKR collected 400 from pot
*** SUMMARY ***
Total pot 400 | No rake
Board: [6s 4s Ah]
Seat 3: _SKR (big blind) won 400


Winamax Poker - Tournament "Expresso Nitro" buyIn: 0.93€ + 0.07€ level: 2 - HandId: #2717232869658329089-7-1676213234 - Holdem no limit (15/30) - 2023/02/12 14:47:14 UTC
Table: 'Expresso Nitro(632655078)#0' 3-max (real money) Seat #3 is the button
Seat 2: Bluemoon2b (500)
Seat 3: _SKR (400)
*** ANTE/BLINDS ***
_SKR posts small blind 15
Bluemoon2b posts big blind 30
Dealt to _SKR [3c 8d]
*** PRE-FLOP *** 
_SKR folds
Bluemoon2b collected 45 from pot
*** SUMMARY ***
Total pot 45 | No rake
Seat 2: Bluemoon2b (big blind) won 45


Winamax Poker - Tournament "Expresso Nitro" buyIn: 0.93€ + 0.07€ level: 2 - HandId: #2717232869658329089-8-1676213238 - Holdem no limit (15/30) - 2023/02/12 14:47:18 UTC
Table: 'Expresso Nitro(632655078)#0' 3-max (real money) Seat #2 is the button
Seat 2: Bluemoon2b (515)
Seat 3: _SKR (385)
*** ANTE/BLINDS ***
Bluemoon2b posts small blind 15
_SKR posts big blind 30
Dealt to _SKR [2s Jh]
*** PRE-FLOP *** 
Bluemoon2b raises 485 to 515 and is all-in
_SKR folds
Bluemoon2b collected 545 from pot
*** SUMMARY ***
Total pot 545 | No rake
Seat 2: Bluemoon2b (small blind) (button) won 545


Winamax Poker - Tournament "Expresso Nitro" buyIn: 0.93€ + 0.07€ level: 2 - HandId: #2717232869658329089-9-1676213245 - Holdem no limit (15/30) - 2023/02/12 14:47:25 UTC
Table: 'Expresso Nitro(632655078)#0' 3-max (real money) Seat #3 is the button
Seat 2: Bluemoon2b (545)
Seat 3: _SKR (355)
*** ANTE/BLINDS ***
_SKR posts small blind 15
Bluemoon2b posts big blind 30
Dealt to _SKR [Kc Js]
*** PRE-FLOP *** 
_SKR raises 325 to 355 and is all-in
Bluemoon2b folds
_SKR collected 385 from pot
*** SUMMARY ***
Total pot 385 | No rake
Seat 3: _SKR (small blind) (button) won 385


Winamax Poker - Tournament "Expresso Nitro" buyIn: 0.93€ + 0.07€ level: 2 - HandId: #2717232869658329089-10-1676213253 - Holdem no limit (15/30) - 2023/02/12 14:47:33 UTC
Table: 'Expresso Nitro(632655078)#0' 3-max (real money) Seat #2 is the button
Seat 2: Bluemoon2b (515)
Seat 3: _SKR (385)
*** ANTE/BLINDS ***
Bluemoon2b posts small blind 15
_SKR posts big blind 30
Dealt to _SKR [5s 5c]
*** PRE-FLOP *** 
Bluemoon2b calls 15
_SKR raises 355 to 385 and is all-in
Bluemoon2b calls 355
*** FLOP *** [2s 9h Qc]
*** TURN *** [2s 9h Qc][Ks]
*** RIVER *** [2s 9h Qc Ks][4h]
*** SHOW DOWN ***
_SKR shows [5s 5c] (One pair : 5)
Bluemoon2b shows [Ah 9s] (One pair : 9)
Bluemoon2b collected 770 from pot
*** SUMMARY ***
Total pot 770 | No rake
Board: [2s 9h Qc Ks 4h]
Seat 2: Bluemoon2b (small blind) (button) showed [Ah 9s] and won 770 with One pair : 9
Seat 3: _SKR (big blind) showed [5s 5c] and lost with One pair : 5


